AA	ɑ	а
AE	æ	э
AH	ʌ	а
AO	ɔ	о
AW	aʊ	ау
AY	aɪ	ай
B	b	б
CH	tʃ	ч
D	d	д
DH	ð	з
EH	ɛ	э
ER	ɝ	е
EY	eɪ	эй
F	f	ф
G	g	г
HH	h	х
IH	ɪ	и
IY	i	и
JH	dʒ	дж
K	k	к
L	ɫ	л
M	m	м
N	n	н
NG	ŋ	н
OW	oʊ	оу
OY	ɔɪ	ой
P	p	п
R	r	р
S	s	с
SH	ʃ	ш
T	t	т
TH	θ	cф
UH	ʊ	у
UW	u	ю
V	v	в
W	w	в
Y	j	й
Z	z	з
ZH	ʒ	ж